10
000000000000000000000000000008
040000000004000000000400000046
000040077000700040000070040006
000000000010000000700000007006
070070000070007000000000000006
400000400000400000004000004006
700000000000000000000070000006
070400000470700740000000407006
0000000000000000000000000000p6
005575557505055055755505550576
