10
000000000000000000000000000000
000000000000000700000002000000
100200009000000200044444000000
444400044444444400000000000100
555000055555555500000000000400
000004455555555500444900909500
000005555500000500055444444500
004445555500000000000000000000
p05555555510000002000000000206
445555555549944444444444444444