10
000000000000000000000000000000
000000020000000000000000000100
000144440002000000000000004400
000000054444000200000009005500
000000000005444400000044445500
000000000000000540000000000000
000004400000000002004000000000
000005540002004444005490002000
p04445554444005555005544444006
445555555555445555995555555444