10
000000000000000000055555555555
000000000000006001655000055555
p00000330600000046500000155555
660006666500000005000006655500
556000000006006665000605555000
555600000025065555600000500006
555500066665055000000000000004
500000355100000000006600006600
510026655600000020605596200007
566665555560966669095555666666