10
600000000000000000455555005555
510000004600000200155555000055
566000000530666666655505600055
555300006560555500000400000005
555660005556500000002200060005
555556005555000006666600059005
p00000000000000065555500656005
666600060000060000004569554000
555500650000022000016556550908
555500559066666966665555556666