10
660000000066666666600060006666
601002000000046666600000046666
607777000007000000003707106066
600000000076707000777606776006
677000007000000070000606600002
660000776000000760000006607777
p00377666077757640000000020008
770766060000676007770077770077
600020002700000276660001660002
677777777657777766665577667777