10
03033363001600000000000000033
000001600076000070007700033008
073707670060030007000630003077
000000037000703006700603003006
777000000007633036000633303006
000003030706600036007603003706
000070000006630030000630003006
000030030076600000700600000006
p07030000000630002000630000736
770537070777607777050666666666