10
663000060004000046666666666666
600000000300007100666006000060
607370077077006770060006000004
006000036060006067000700033070
076077000020000000777600777760
p00006777770000770002002666600
770700000004700007777777660008
660677700070007740000000004777
600020020761006670001070000026
677777770667056667557567577776