10
666660006666666666660000060666
600004700666660666600001060666
600700670600004606000707000066
000607600600770006070650077006
007656601600667700000477506006
006676007670066600700006706706
076660006660060000600700600609
p00004700060760777000600000007
700770600000661000270600077756
670067657577667777765675766676