10
000000000000002000001600000007
000460000006666000006530006666
000050000600000066000560000055
p00656600400000000000056040005
600055560000661000460005006005
500055556360550000050000095605
560055555650000066650600065005
000655555550000655559500000065
100555555559660555555566100255
669555555556559555555555666655