10
000000000000000000000000020000
010020000000000000000144444000
044440003003000000000455500000
055554004444000000020000000008
000000000005400044440000000044
000000000000000455550004440055
000004400000000000000005550055
003005501044400700000045550055
p44405504055500000002455550055
455595595955500444444555559955