10
777077700000000000077770707007
606060607000000777060060606706
676060606070777600067060606676
606060606700606670060060606066
676067606070676600060067606006
000000000000000000000000000000
000000000000000000000000000000
000000000000000000000000000000
p00000000000000000000000000009
777777777777777777777770000007